0005 0005 0005 0005 0005 0005 0005 0005 0005
0005 0005 0005 0005 0005 0005 0005 0005 0005
0005 0005 0005 0005 0005 0005 0005 0005 0005
0005 0005 0005 0005 0005 0005 0005 0005 0005
0005 0005 0005 0005 0005 0005 0005 0005 0005
0005 0005 0005 0005 0005 0005 0005 0005 0005
0005 0005 0005 0005 0005 0005 0005 0005 0005
0005 0005 0005 0005 0005 0005 0005 0005 0005
0001 0001 0001 0001 0001 0001 0001 0001 0001 0001 0001
0001 0001 0001 0001 0001 0001 0001 0001 0001 0001 0001
0001 0001 0001 0001 0001 0001 0001 0001 0001 0001 0001
0001 0001 0001 0001 0001 0001 0001 0001 0001 0001 0001
0001 0001 0001 0001 0001 0001 0001 0001 0001 0001 0001
0001 0001 0001 0001 0001 0001 0001 0001 0001 0001 0001
0001 0001 0001 0001 0001 0001 0001 0001 0001 0001 0001
0001 0001 0001 0001 0001 0001 0001 0001 0001 0001 0001
0001 0001 0001 0001 0001 0001 0001 0001 0001 0001 0001
0001 0001 0001 0001 0001 0001 0001 0001 0001 0001 0001
0001 0001 0001 0001 0001 0001 0001 0001 0001 0001 0001
0001 0001 0001 0001 0001 0001 0001 0001 0001 0001 0001
0001 0001 0001 0001 0001 0001 0001 0001 0001 0001 0001
0001 0001 0001 0001 0001 0001 0001 0001 0001 0001 0001
0001 0001 0001 0001 0001 0001 0001 0001 0001 0001 0001
0001 0001 0001 0001 0001 0001 0001 0001 0001 0001 0001
0001 0001 0001 0001 0001 0001 0001 0001 0001 0001 0001
0001 0001 0001 0001 0001 0001 0001 0001 0001 0001 0001
0001 0001 0001 0001 0001 0001 0001 0001 0001 0001 0001
0001 0001 0001 0001 0001 0001 0001 0001 0001 0001 0001
0001 0001 0001 0001 0001 0001 0001 0001 0001 0001 0001
0001 0001 0001 0001 0001 0001 0001 0001 0001 0001 0001
0005 0005 0005 0005 0005 0005 0005 0005 0005 0005 0005
0005 0005 0005 0005 0005 0005 0005 0005 0005 0005 0005
0005 0005 0005 0005 0005 0005 0005 0005 0005 0005 0005
0005 0005 0005 0005 0005 0005 0005 0005 0005 0005 0005
0005 0005 0005 0005 0005 0005 0005 0005 0005 0005 0005
0005 0005 0005 0005 0005 0005 0005 0005 0005 0005 0005
0005 0005 0005 0005 0005 0005 0005 0005 0005 0005 0005
0005 0005 0005 0005 0005 0005 0005 0005 0005 0005 0005
0005 0005 0005 0005 0005 0005 0005 0005 0005 0005 0005
0005 0005 0005 0005 0005 0005 0005 0005 0005 0005 0005
0005 0005 0005 0005 0005 0005 0005 0005 0005 0005 0005
